Disease	repeat_unit	score	sequence
FRAXA	CGG	111	GAGCGCGGGCGGCGGCGGTGACGGAGGCGCCGCTGCCAGGGGGCGTGCGGCAGCgcggcggcggcggcggcggcggcggcggcggaggcggcggcggcggcggcggcggcggcggcTGGGCCTCGAGCGCCCGCAGCCCACCTCTCGGGGGCGGGC
FRAXE	GCC	121	TGTAAGTGTGTGATGCTGCCGCGgccgccgccgccgcctgtgcagccgctgccgccgccgccgccgccgccgccgccgccgccgccgccgccgccgcTGCCGCCCCGGCTGCCGCGCCGCGCCGCTGCCTCTGCCCCGGCCGCCCCCGCCGCCGCTG
FRDA	GAA	34	GACTAACCTGGCCAACATGGTGAAACCCAGTATCTACTAAAAAATACAAAAAAAAAAAAAAaagaagaagaagaagaagaaAATAAAGAAAAGTTAGCCGGGCGTGGTGTCGCGCGCCTGTAATCCCAGCTACTCCAGAGG
DM1	CAG	72	TTTGCCCATCCACGTCAGGGCCTCAGCCTGGCCGAAAGAAAGAAATGGTCTGTGATCCCCCcagcagcagcagcagcagcagcagcagcagcagcagcagcagcagcagcagcagcagcagcaTTCCCGGCTACAAGGACCCTTCGAGCCCCGTTCGCCGGCCGCGGACCCGG
DM2	GGCA	80	AGCCGAGATCATACCACTGCACTCCAGCCTAGGGGACAAAGTGAGACAGAcaggcaggcaggcaggcaggcaggcaggcagacaggcagacaggcagccaggcaggcaggcaggcaggcaggcaggcaggcagACAGACAGACAGACAGACAGACAGACAGACAGACAGACACACACACACAC
SCA10	ATTCT	75	GGCTTAAATATCCAACTAAAAGACTACTAGAATGGattctattctattctattctattctattctattctattctattctattctattctattctattctattctTTTTGAGATGAAGTCTCTCTATGTTGCCCAGGCTGGAGTGCAGTGG
EPM1	CGCGGGGCGGGG	37	TTCGGAGTCCCCTGCGGGGTCGCGGTGGCCCCGCAAGAAGGGACgcgcggggcggggcgcggggcggggcgcggggcggggAACCTGGCCACCACTCGCCGCAGGCTGGGTCTCCGCGCCCAGCGCTGGTG
HD	CAG	66	ATGGCGACCCTGGAAAAGCTGATGAAGGCCTTCGAGTCCCTCAAGTCCTTCcagcagcagcagcagcagcagcagcagcagcagcagcagcagcagcagcagcagcagcaACAGCCGCCACCGCCGCCGCCGCCGCCGCCGCCTC
SBMA	CAG	118	GGCCCCAGGCACCCAGAGGCCGCGAGCGCAGCACCTCCCGGCGCCAGTTTGCTGCTGCTgcagcagcagcagcagcagcagcagcagcagcagcagcagcagcagcagcagcagcagcagcagcagcaagagactagccccaggcagcagcagcagcagcagGGTGAGGATGGTTCTCCCCAAGCCCATCGTAGAGGCCCC
SCA1	CTG	118	CGTACTGGTTCTGCTGGGCTGGTGGGGGGGACCCCGGGGTGATGAGCCCCGGAGCCCTGCTGAGGtgctgctgctgctgctgctgctgctgctgctgctgctgctgctgatgctgatgctgctgctgctgctgctgctgctgctgctgctgctgctCAGCCTTGTGTCCCGGCGTCTGGCTCAGACTGCCCATGTTGGCCA
SCA2	CTG	89	ACGCTAGAAGGCCGCTGCCGCCGGGCTTGCGGACATTGGCAGCCGCGGGCGGCGgctgctgctgctgctgctgctgctgctgttgctgctgctgctgctgctgctgctgctgctgctgctgctgGGGCTTCAGCGACATGGTGAGGGGCCCATACACCGGCTCGCACGCCGGGCGGGGACAGCCGGGAGCCGGGCGCGCCA
SCA3	CTG	58	CTGAACTGGTGGCTGGCCTTTCACATGGATGTGAACTCTGTCCTGATAGGTCCCCctgctgctgctgctgctgctgctgTTGCTGCTTTTGCTGCTGTCTGAAACATTCAAAAGTGAAGTATATTTAAAAAACAAAACTTAAAAGAATAAA
SCA6	CTG	47	CGAGGGCCGCTGGTGGCCGCCCGGCCCGGCCTGGCCACCGCctgctgctgctgctgctgctgctgctgctgctgctgctgcGGGGGCCCCGAGCCGCCGGCCTTACGGATCACAGGGGAAT
SCA7	CAG	62	TCAGGGGGGAGCCGCGCCGCGCGGCGGCGGCGGCGGGCGGAGCAGCGGCCGCGGCCGCCCGgcagcagcagcagcagcagcagcagcagcagcCGCCGCCTCCGCAGCCCCAGCGGCAGCAGCACCCGCCACCGCCGCCACGG
SCA17	CAG	148	ACAGCCTATTCAGAACACCAATAGTCTGTCTATTTTGGAAGAGCAACAAAGgcagcagcagcaacaacaacagcagcagcagcagcagcagcagcaacagcaacagcagcagcagcagcagcagcagcagcagcagcagcagcagcagcagcagcagcagcaACAGGCAGTGGCAGCTGCAGCCGTTCAGCAGTCAACGTCCCAGCAGGCAACACAGGGAA
DRPLA	CAG	64	CACCGCCCACCCACCAGTCTCAACACATCACCATCACCACCAGCAACAGCAAcagcagcagcagcagcagcagcagcagcagcagcagcagcagcagcaTCACGGAAACTCTGGGCCCCCTCCTCCTGGAGCATTTCCCCACCCACTGG
SCA8	CTG	52	ATGTTAGAAAACCTGGCTTTACTACTACTACTACTACTACTACTACTACTActgctgctgctgctgctgctgctgctgctgctgctgctgctgctgcATTTTTTAAAAATATATTATCTTATTTTACTATTTGATG
SCA12	CTG	49	TGCAGCCGGCGCCAGCGCACTCACCCTCACACCCACACGCGCGCACTCGCAgctgctgctgctgctgctgctgctgctgctgcAGGAGGCTGGAGGCGGCTGGTGCATTAAAGGCGAGGCTCCTCCCAACCGC
HDL2	CTG	68	ATTCTAAGATGCCACCGCATTCGGGGCAGAGCCGGGGCCGGAAGCCAGGGAGCTGCctgctgctgctgctgctgctgctgctgctgctgctgctgctgTAAGATGGTTTCTGTGCAGGGAACCTTGGCCGGCTCTGCAGCTGCCCGCC
FTDALS	GGCCCC	47	CACTCACCCACTCGCCACCGCCTGCGCCTCCGCCGCCGCGGGCGCAGGCACCGCAACCGCAGCCCCGCCCCGGGCCCGCCCCCGGGCCCGCCCCGACCACgccccggccccggccccggccccTAGCGCGCGACTCCTGAGTTCCAGAGCTTGCTACAGGCTG
SCA36	GGCCTG	37	GCGCGGGCGACGCGACGGTGGGGGTTTCGGCCTGCGTTCGGGCCGCAGACAgggcctgggcctgggcctgggcctgCGCCTGCGCCTGCGCCTGCCCTGGGAACGGGTTCCGGCAGACGCTGAGGTTGCGTTGACGCTCGCGCCCCGGCTCCCG
#END#
